11111111111111111111
100C00C00C000A110001
10001100011000A10001
1P00AA000110000000E1
11111111111111111111