11111111111111111111
100C00C00C0000110001
10001100011000010001
1P0000000110000000E1
11111111111111111111