1111111111111111111111
100C00C00C000000000111
1000000000000000000111
1P0000000000000000E111
1111111111111111111111
1111111111111111111111
1111111111111111111111