1111111111111111111111111
100C00C00C000000000111011
1000000000000000000111111
1P0000000000000000E11AA11
11111111111111111111AAA11
11111111111111111111AAA11
1111111111111111111111111