111111111111111111111111111111111111111
1P0000000000000000000000110000001100001
1000000000000000000AA100000000000000001
100000001110000000000000011110000000001
100000000000111000000000111000000000001
110000000000000000000000000000000000011
1AA000000000000000CC11AA000000000000011
1C000000000C0000000000000AA000000000001
1110000000001100000000000110000011E1111
111111111111111111111111111111111111111