111111111111
1P00C0011111
111111111111
111111111111