111111111111111
1P00P0000000001
100000000000001
10E000CCCC0EEE1
1000CC00CC00001
111111111111111