111111111111111
100P0000000E001
100000000000C01
10000000AA00001
100000000000001
100000000000001
111111111111111