111111111111111
1P0000000000001
100000000000C01
1E000000AA00001
100000000000001
100000000000001
111111111111111