1111111111111111
1000000000111111
1PEC000000111111
1000010000111111
1000000000111111
1111111111111111
1111111111111111